11111111111111111
1P0010C01C0011C01
10000010000010001
11001011001000001
1C0000000000001E1
11111111111111111