1111111111111111111111111111111111
1ECCCCCCCCCCCCCCCCCCCCCCCCCCCCCCC1
1110010100100000101001000000010101
1010010010101010001001CCCCCC010101
1PCCCCCCCCCCC1CCCCCCCCCCCCCCCCCCC1
1111111111111111111111111111111111