11111111111111111
1P0010001C0011C01
10000C000A0010001
11101011001000001
100A0C010C00A01E1
11111111111111111